C 225,30,122
SO      ./textures/south.png
NO  ./textures/north.png






WE ./textures/west.png

EA ./textures/est.png

F 220,    255 ,0

1111111111111111111111
100000010000000000001
100000011111111000001
100000000100000000001
100000000010000000001
100000000111111000001
10000S000000000000001
111111111111111111111