NO  test.xpm
SO  test.xpm






C 225,30,122
WE test.xpm

EA test.xpm

F 220,    255 ,0
    11111 1
    100101
    1010N1
  1111111111
111111
110001
1111111
