NO  test.xpm
SO  test.xpm






C 225,30,122
WE test.xpm

EA test.xpm

F 220,    255 ,0
    11111 1
    100001
  110000N1
  10000001
110000001
11000001
1111111
