NO  test.xpm
SO  test.xpm






C 225,30,122
WE test.xpm

EA test.xpm

F 220,    255 ,0

1111111111111111111111
100000010000000000001
100000011111111000001
100N00000100000000001
100000000000000000001
100000000111111000001
100000000000000000001
111111111111111111111