NO   ./textures/north.png
EA   ./textures/east.png
SO   ./textures/south.png
WE   ./textures/west.png

F 20,20,20
C 200,200,200

1111111111111111111111111
111N000000000000000000011
1111111111111111111111111