C 102,   178,   255
SO      ./textures/girl_with_a_pearl_earring.png
NO  ./textures/monalisa.png






WE ./textures/starry_nights.png

EA ./textures/the_scream.png

F 153,76,0

 11111111111111111111111
1W0000010000000000000001
10000001111111100000111
100000000100000000001
100000000010000000001
100000000111111000001
10000000000000000001
111111111111111111111