C 23, 27, 38
SO      ./textures/south.png
NO  ./textures/north.png



WE ./textures/west.png

EA ./textures/est.png

F 209,201,210

1111111111111111111111
100000010000000000001
100000011111111000001
100E00000100000000001
100000000010000000001111111111111
100000000111111000001
100000000000000000001
111111111111111111111