C 23, 27, 38
SO      ./textures/girl_with_a_pearl_earring.png
NO  ./textures/monalisa.png



WE ./textures/starry_nights.png

EA ./textures/the_scream.png

F 209,201,210

1111111111111111111111
100000010000000000001
100000011111111000001
100N00000100000000001
100000000010000000001
100000000111111000001
100000000000000000001
111111111111111111111