C 23, 27, 38
SO      ./textures/girl_with_a_pearl_earring.png
NO  ./textures/monalisa.png



WE ./textures/starry_nights.png

EA ./textures/the_scream.png

F 64,64,252

11111
1W0101
101011
111111