SO      ./textures/south.png 


WE       ./textures/west.png

NO ./textures/monalisa.png

EA ./textures/est.png

F 209 , 201 ,     210

    C 23, 27, 38

111111111111111111111
1111111111111111111
11111111111111111101111111111
11111111111111111010011   1
1111111111111100000011111111111111111
100000111111101N00001111  1
1111111111111110111101111
1111111111111111111111111