SO ./textures/south.png 
WE ./textures/west.png
NO ./textures/north.png
EA ./textures/est.png

F 209,201,210
C 23,27,38

111111111111111111111
1111111111111111111
11111111111111111101111111111
11111111111111111010011   1
1111111111111100000011111111111111111
100000111111101000001111  1
1111111111111110111101111
1111111110110000011100001
10000000001100S001110111111111111
1000000000000000000000000000010111
110001000000000000000000010101111
110000000001010000000000010011
10000000000000000000000010011
1000000000000000000000000001
11000000000010000000110000011
10001010000000000000000001011
110000001101010000000000010011
10000000000000000000000000011
1000000000000000001010010001
11000000000010100000000000011
10001011110000011111000001011
11111111 1111111 111111111111