SO ./textures/moon.png 
WE ./textures/moon.png
NO ./textures/moon.png
EA ./textures/moon.png

F 255,0,255
C 23,27,255

1111111111111
1N00000000001
111111111111