SO ./textures/moon.png 
WE ./textures/west.png
NO ./textures/west.png
EA ./textures/west.png

F 255,0,255
C 23,27,255

        1111111111111111111111111
        1000000000110000000000001
        1011000001110000000000001
        1001000000000000000000001
111111111011000001110000000000001
100000000011000001110111111111111
111101111111110111000000000011111
111101111111110111010100100011111
110000001101010000000000100011111
100000000000000001000000100011111
100000000000000000010100100011111
11000001110101011111011110N011111
11110111 1110101 1011110100011111
11111111 1111111 1111111111111111