SO      ./textures/south.png 

NO ./textures/north.png

WE ./textures/west.png

EA ./textures/est.png

F 209 , 201 ,     210

    C 23, 27, 38

1111111111111111111111
1111111111111111111
11111111111111111111111111111
11111111111111111111011   1
111111111111111011110111110111
1000001111111001E0000011111  1
1111111111111111111101111
111111111111111111111111111