C 23, 27, 38
    SO      ./textures/girl.png
NO ./textures/monalisa.png



WE ./textures/starry_nights.png

EA ./textures/the_scream.png

F 209,201,210

1111111111111111111111
1111111111111111111
11111111111111111111111111111
1111111111111111111101   11
111111111111111111110111110111
1000001111111000E00000111 1 11  1
1111111111111111111101111
1111111111111111111111111111